9 26
26
abcdefghijklmnopqrstuvwxyz
..........................
..........................
..........................
..........................
..........................
..........................
..........................
ABCDEFGHIJKLMNOPQRSTUVWXYZ
A:N.N.N.N.N.N.N.N
B:N.N.N.N.N.N.N.N
C:N.N.N.N.N.N.N.N
D:N.N.N.N.N.N.N.N
E:N.N.N.N.N.N.N.N
F:N.N.N.N.N.N.N.N
G:N.N.N.N.N.N.N.N
H:N.N.N.N.N.N.N.N
I:N.N.N.N.N.N.N.N
J:N.N.N.N.N.N.N.N
K:N.N.N.N.N.N.N.N
L:N.N.N.N.N.N.N.N
M:N.N.N.N.N.N.N.N
N:N.N.N.N.N.N.N.N
O:N.N.N.N.N.N.N.N
P:N.N.N.N.N.N.N.N
Q:N.N.N.N.N.N.N.N
R:N.N.N.N.N.N.N.N
S:N.N.N.N.N.N.N.N
T:N.N.N.N.N.N.N.N
U:N.N.N.N.N.N.N.N
V:N.N.N.N.N.N.N.N
W:N.N.N.N.N.N.N.N
X:N.N.N.N.N.N.N.N
Y:N.N.N.N.N.N.N.N
Z:N.N.N.N.N.N.N.N
